08 08 08 08 08 08 08 08 08 08 08 08 08 08 08 08 08 08 08 08 08 08 08 08 08 08 08 08 08 08 08 08 08 08 08 08 08 08 08 08 08 08 08 08 08 08 08 08 08 08
08 08 08 08 08 08 08 08 08 08 08 08 08 08 08 08 08 08 08 08 08 08 08 08 08 08 08 08 08 08 08 08 08 08 08 08 08 08 08 08 08 08 08 08 08 08 09 09 08 08
08 08 13 11 11 11 11 11 11 11 11 11 11 14 08 08 08 08 08 08 08 08 08 08 08 08 08 08 08 08 08 08 08 08 09 09 09 09 09 09 09 09 09 09 09 09 09 09 08 08
08 08 12 09 09 09 09 09 09 09 09 09 09 15 08 08 08 08 08 08 08 08 08 08 08 08 08 08 08 08 08 08 08 08 09 08 08 08 08 08 08 08 08 08 08 08 09 09 08 08
08 08 12 09 09 09 09 09 09 09 09 09 09 15 08 08 08 08 08 08 08 08 08 08 08 08 08 08 08 08 08 08 08 08 09 08 08 08 08 08 08 08 08 08 08 08 08 08 08 08
08 08 12 09 09 09 09 09 09 09 09 09 09 15 08 08 08 08 08 08 08 08 08 08 08 08 08 08 09 09 09 09 09 09 09 08 08 08 08 08 08 08 08 08 08 08 08 08 08 08
08 08 12 09 09 09 09 09 09 09 09 09 09 15 08 08 08 08 08 08 08 08 08 08 08 08 08 08 09 08 08 08 08 08 09 08 08 08 08 08 08 08 08 08 08 08 08 08 08 08
08 08 12 09 09 09 09 09 10 09 09 09 09 15 09 09 09 09 09 09 09 09 09 08 08 08 08 08 09 08 08 08 08 08 09 08 08 08 08 08 08 08 08 08 08 08 08 08 08 08
08 08 12 09 09 02 03 03 10 03 03 04 09 15 09 09 09 09 09 09 09 09 09 08 08 08 08 08 09 08 08 08 08 08 09 08 08 08 08 08 08 08 08 08 08 08 08 08 08 08
08 08 12 09 09 01 06 06 10 06 06 05 09 15 09 09 09 09 09 09 09 09 09 08 08 08 08 08 09 08 08 08 08 08 09 08 08 08 08 08 08 08 08 08 08 08 08 08 08 08
08 08 12 09 09 01 06 06 10 06 06 05 09 15 09 09 09 09 09 09 09 09 09 08 08 08 08 08 09 08 08 08 08 08 09 08 08 08 08 08 08 08 08 08 08 08 08 08 08 08
08 08 12 09 09 01 06 06 10 06 06 05 09 15 09 09 09 09 09 09 09 09 09 08 08 08 08 08 09 08 08 08 08 08 09 09 09 09 09 09 09 09 09 09 09 09 09 09 08 08
08 08 12 09 09 01 06 06 10 06 06 05 09 15 09 09 09 09 09 09 09 09 09 08 08 08 08 08 09 08 08 08 08 08 08 08 08 08 08 08 08 08 08 08 08 08 08 09 08 08
08 08 12 09 09 01 06 06 10 06 06 05 09 15 09 09 09 09 09 09 09 09 09 08 08 08 08 08 09 09 09 09 09 09 09 08 08 08 08 08 08 08 08 08 08 08 08 09 08 08
08 08 16 11 11 11 11 11 08 11 11 11 11 17 09 09 09 09 09 09 09 09 09 08 08 08 08 08 08 08 08 08 08 08 09 08 08 08 08 08 08 08 08 08 08 08 08 09 08 08
08 08 09 09 09 09 09 09 08 09 09 09 09 09 09 09 09 09 09 09 09 09 09 08 08 08 08 08 08 08 08 08 08 08 09 08 08 08 08 08 08 08 08 08 08 08 08 09 08 08
08 08 09 09 09 09 09 09 08 09 09 09 09 09 09 09 09 09 09 09 09 09 09 08 08 08 08 08 08 08 09 08 08 08 09 08 08 08 08 08 08 08 08 08 08 08 08 09 08 08
08 08 09 09 09 09 09 09 08 09 09 09 09 09 09 09 09 09 09 09 09 09 09 08 08 08 08 08 08 08 09 08 08 08 09 08 08 08 08 08 08 08 08 08 08 08 08 09 08 08
08 08 09 09 09 09 09 09 08 09 09 09 09 09 09 09 09 09 09 09 09 09 09 08 08 08 08 08 08 08 09 09 09 09 09 08 02 03 03 03 03 03 03 03 04 08 08 09 08 08
08 08 09 09 09 09 09 09 08 09 09 09 09 09 09 09 09 09 09 09 09 09 09 08 08 08 08 08 08 08 09 08 08 08 08 08 01 06 06 06 06 06 06 06 05 08 08 09 08 08
08 08 09 09 09 09 09 09 08 08 08 08 08 08 08 08 08 08 08 08 08 08 08 09 09 09 09 09 09 09 09 09 09 09 08 08 01 06 06 09 09 09 06 06 05 08 08 09 08 08
08 08 09 09 09 09 09 09 09 09 09 09 08 09 09 09 09 09 09 09 08 09 09 08 08 08 08 08 08 09 08 08 08 08 08 08 01 06 06 09 09 09 06 06 05 08 08 09 08 08
08 08 09 09 09 09 09 09 09 09 09 09 08 09 09 09 09 09 09 09 08 09 09 08 08 08 08 08 08 09 08 08 08 08 08 08 01 06 06 09 09 09 06 06 05 08 08 09 08 08
08 08 09 09 09 09 09 09 09 09 09 09 08 09 09 09 09 09 09 09 08 09 09 08 08 08 08 08 08 09 08 08 08 08 08 08 01 06 06 06 10 06 06 06 05 08 08 09 08 08
08 08 09 09 09 09 09 09 09 09 09 09 08 09 09 09 09 08 08 09 08 09 09 08 08 08 08 08 08 09 08 08 08 08 08 08 01 06 06 06 10 06 06 06 05 08 08 09 08 08
08 08 09 09 09 09 09 09 09 09 09 09 08 09 09 08 08 08 09 09 08 09 09 08 08 08 08 08 08 09 08 08 08 08 08 08 01 06 06 06 10 06 06 06 05 08 08 09 08 08
08 08 09 09 09 09 09 09 09 09 09 09 08 09 09 08 09 09 09 09 08 09 09 08 08 08 08 08 08 09 09 09 09 09 09 09 08 08 08 08 09 08 08 08 08 08 08 09 08 08
08 08 09 09 09 09 09 09 09 09 09 09 08 09 09 08 08 08 09 09 08 09 09 08 08 08 08 08 08 09 08 08 08 08 08 08 08 08 08 08 09 08 09 08 08 08 08 09 08 08
08 08 09 09 09 09 09 09 09 09 09 09 08 09 09 09 09 09 09 09 08 09 09 08 08 08 08 08 08 09 08 08 08 08 08 08 08 08 08 08 09 09 09 08 08 08 08 09 08 08
08 08 09 09 09 09 09 09 09 09 09 09 08 09 09 09 09 09 09 09 08 09 09 08 08 08 08 08 08 09 08 08 08 08 08 08 08 08 08 08 08 08 09 08 08 08 08 09 08 08
08 08 09 09 09 09 09 09 09 09 09 09 08 09 09 09 09 09 09 09 08 09 09 08 08 08 08 08 08 09 08 08 08 08 08 08 08 08 08 08 08 08 09 08 08 08 08 09 08 08
08 08 09 09 09 09 09 09 09 09 09 09 08 09 09 09 09 08 08 09 08 09 09 08 08 08 09 09 09 09 08 08 08 08 08 08 08 09 08 08 08 08 09 08 08 08 08 09 08 08
08 08 09 09 09 09 09 09 09 09 09 09 08 09 09 09 09 09 09 09 08 09 09 08 08 08 09 08 08 08 08 08 08 08 08 08 08 09 08 08 08 08 09 08 08 08 08 09 08 08
08 08 09 09 09 09 09 09 09 09 09 09 08 09 09 09 09 09 09 09 08 09 09 08 08 08 09 08 08 08 08 08 08 08 08 08 08 09 08 08 08 08 09 08 08 08 08 09 08 08
08 08 09 09 09 09 09 09 09 09 09 09 08 09 09 09 09 09 09 09 08 09 09 08 08 08 09 08 08 08 08 08 08 08 08 08 08 09 08 08 08 08 09 08 08 08 08 09 08 08
08 08 09 09 09 09 09 09 09 09 09 09 08 09 09 09 09 09 09 09 08 09 09 08 08 08 09 08 08 08 08 08 08 08 08 08 08 09 08 08 08 08 09 08 08 08 08 09 08 08
08 08 09 09 09 09 09 09 09 09 09 09 08 09 09 09 09 09 09 09 08 09 09 08 08 08 09 08 08 08 08 08 08 08 08 08 09 09 09 09 09 09 09 08 08 08 08 09 08 08
08 08 09 09 09 09 09 09 09 09 09 09 08 09 09 09 09 09 09 09 08 09 09 08 08 08 09 08 09 08 09 09 09 09 08 08 09 08 08 08 08 08 09 08 08 08 08 09 08 08
08 08 09 09 09 09 09 09 09 09 09 09 08 09 09 09 09 09 09 09 08 09 09 08 08 08 09 08 09 08 09 08 08 09 08 08 09 08 08 08 08 08 09 08 08 08 08 09 08 08
08 08 09 09 09 09 09 09 09 09 09 09 08 08 08 08 08 08 08 08 08 09 09 08 08 08 09 09 09 08 09 08 08 09 08 08 09 08 08 08 08 08 09 08 08 08 08 09 08 08
03 03 03 03 03 03 03 03 03 03 03 04 09 09 09 09 09 09 08 09 09 09 09 08 08 08 08 09 08 08 09 08 08 09 08 08 09 08 08 08 08 08 09 08 08 08 08 09 08 08
06 06 06 06 06 06 06 06 06 06 06 05 09 09 09 09 09 09 08 09 09 09 09 08 08 08 08 09 08 08 09 08 08 09 08 08 09 08 08 08 08 08 09 08 08 08 08 09 08 08
06 06 06 06 06 06 06 06 06 06 06 05 09 09 09 09 09 09 08 09 09 09 09 08 08 08 08 09 08 08 09 08 08 09 08 08 09 08 08 08 08 08 09 08 08 08 08 09 08 08 
06 06 06 06 06 06 06 06 06 06 06 05 08 08 08 08 08 08 08 09 09 09 09 08 08 08 08 09 08 08 09 08 09 09 08 08 09 08 08 08 08 08 09 09 09 09 09 09 08 08
06 06 06 06 06 06 06 06 06 06 06 05 08 09 09 09 09 09 08 08 08 08 08 08 08 08 08 09 08 08 09 08 08 08 08 08 09 08 08 08 08 08 08 08 08 08 08 08 08 08
06 06 06 06 06 06 06 06 06 06 06 05 08 09 09 09 09 09 08 09 09 09 09 08 08 08 08 09 08 08 09 08 08 08 08 08 09 08 08 08 08 08 08 08 08 08 08 08 08 08
06 06 06 06 06 06 06 06 06 06 06 05 08 09 09 09 09 09 08 09 09 09 09 08 08 08 08 09 08 08 09 09 09 09 09 09 09 08 08 08 08 08 08 08 08 08 08 08 08 08
06 06 06 06 06 06 06 06 06 06 06 05 08 08 08 08 08 08 08 08 08 08 08 08 08 08 08 08 08 08 09 08 08 08 08 08 08 08 08 08 08 08 08 08 08 08 08 08 08 08 
06 06 06 06 06 06 06 06 06 06 06 05 08 08 08 08 08 08 08 08 08 08 08 08 08 08 08 08 08 08 08 08 08 08 08 08 08 08 08 08 08 08 08 08 08 08 08 08 08 08 
06 06 06 06 06 06 06 06 06 06 06 05 08 08 08 08 08 08 08 08 08 08 08 08 08 08 08 08 08 08 08 08 08 08 08 08 08 08 08 08 08 08 08 08 08 08 08 08 08 08 